"filename", "language", "Python", "JSON", "Markdown", "CSV", "Django txt", "comment", "blank", "total"
"c:\Users\shado\Desktop\Desktop\Documents\ComputerProgramme\Code\WebBackend\.VSCodeCounter\2022-01-16_12-58-48\details.md", "Markdown", 0, 0, -229, 0, 0, 0, -6, -235
"c:\Users\shado\Desktop\Desktop\Documents\ComputerProgramme\Code\WebBackend\.VSCodeCounter\2022-01-16_12-58-48\diff-details.md", "Markdown", 0, 0, -9, 0, 0, 0, -6, -15
"c:\Users\shado\Desktop\Desktop\Documents\ComputerProgramme\Code\WebBackend\.VSCodeCounter\2022-01-16_12-58-48\diff.csv", "CSV", 0, 0, 0, -2, 0, 0, 0, -2
"c:\Users\shado\Desktop\Desktop\Documents\ComputerProgramme\Code\WebBackend\.VSCodeCounter\2022-01-16_12-58-48\diff.md", "Markdown", 0, 0, -12, 0, 0, 0, -7, -19
"c:\Users\shado\Desktop\Desktop\Documents\ComputerProgramme\Code\WebBackend\.VSCodeCounter\2022-01-16_12-58-48\diff.txt", "Django txt", 0, 0, 0, 0, -19, 0, -3, -22
"c:\Users\shado\Desktop\Desktop\Documents\ComputerProgramme\Code\WebBackend\.VSCodeCounter\2022-01-16_12-58-48\results.csv", "CSV", 0, 0, 0, -222, 0, 0, 0, -222
"c:\Users\shado\Desktop\Desktop\Documents\ComputerProgramme\Code\WebBackend\.VSCodeCounter\2022-01-16_12-58-48\results.json", "JSON", 0, -1, 0, 0, 0, 0, 0, -1
"c:\Users\shado\Desktop\Desktop\Documents\ComputerProgramme\Code\WebBackend\.VSCodeCounter\2022-01-16_12-58-48\results.md", "Markdown", 0, 0, -33, 0, 0, 0, -7, -40
"c:\Users\shado\Desktop\Desktop\Documents\ComputerProgramme\Code\WebBackend\.VSCodeCounter\2022-01-16_12-58-48\results.txt", "Django txt", 0, 0, 0, 0, -260, 0, -3, -263
"c:\Users\shado\Desktop\Desktop\Documents\ComputerProgramme\Code\WebBackend\.VSCodeCounter\2022-01-27_00-12-17\details.md", "Markdown", 0, 0, 96, 0, 0, 0, 6, 102
"c:\Users\shado\Desktop\Desktop\Documents\ComputerProgramme\Code\WebBackend\.VSCodeCounter\2022-01-27_00-12-17\diff-details.md", "Markdown", 0, 0, 28, 0, 0, 0, 6, 34
"c:\Users\shado\Desktop\Desktop\Documents\ComputerProgramme\Code\WebBackend\.VSCodeCounter\2022-01-27_00-12-17\diff.csv", "CSV", 0, 0, 0, 21, 0, 0, 0, 21
"c:\Users\shado\Desktop\Desktop\Documents\ComputerProgramme\Code\WebBackend\.VSCodeCounter\2022-01-27_00-12-17\diff.md", "Markdown", 0, 0, 22, 0, 0, 0, 7, 29
"c:\Users\shado\Desktop\Desktop\Documents\ComputerProgramme\Code\WebBackend\.VSCodeCounter\2022-01-27_00-12-17\diff.txt", "Django txt", 0, 0, 0, 0, 48, 0, 3, 51
"c:\Users\shado\Desktop\Desktop\Documents\ComputerProgramme\Code\WebBackend\.VSCodeCounter\2022-01-27_00-12-17\results.csv", "CSV", 0, 0, 0, 89, 0, 0, 0, 89
"c:\Users\shado\Desktop\Desktop\Documents\ComputerProgramme\Code\WebBackend\.VSCodeCounter\2022-01-27_00-12-17\results.json", "JSON", 0, 1, 0, 0, 0, 0, 0, 1
"c:\Users\shado\Desktop\Desktop\Documents\ComputerProgramme\Code\WebBackend\.VSCodeCounter\2022-01-27_00-12-17\results.md", "Markdown", 0, 0, 38, 0, 0, 0, 7, 45
"c:\Users\shado\Desktop\Desktop\Documents\ComputerProgramme\Code\WebBackend\.VSCodeCounter\2022-01-27_00-12-17\results.txt", "Django txt", 0, 0, 0, 0, 132, 0, 3, 135
"c:\Users\shado\Desktop\Desktop\Documents\ComputerProgramme\Code\WebBackend\Test.py", "Python", 58, 0, 0, 0, 0, 18, 2, 78
"c:\Users\shado\Desktop\Desktop\Documents\ComputerProgramme\Code\WebBackend\Test\Test.py", "Python", -3, 0, 0, 0, 0, 0, 0, -3
"c:\Users\shado\Desktop\Desktop\Documents\ComputerProgramme\Code\WebBackend\Test_pydantic_to_sqlalchemy.py", "Python", -68, 0, 0, 0, 0, -11, -2, -81
"c:\Users\shado\Desktop\Desktop\Documents\ComputerProgramme\Code\WebBackend\src\Models\ModelCurricula.py", "Python", -1, 0, 0, 0, 0, 0, 0, -1
"c:\Users\shado\Desktop\Desktop\Documents\ComputerProgramme\Code\WebBackend\src\Models\ModelDepartment.py", "Python", -1, 0, 0, 0, 0, 0, 0, -1
"c:\Users\shado\Desktop\Desktop\Documents\ComputerProgramme\Code\WebBackend\src\Models\ModelEquipment.py", "Python", -1, 0, 0, 0, 0, 0, 1, 0
"c:\Users\shado\Desktop\Desktop\Documents\ComputerProgramme\Code\WebBackend\src\Models\ModelLocation.py", "Python", -118, 0, 0, 0, 0, 0, -23, -141
"c:\Users\shado\Desktop\Desktop\Documents\ComputerProgramme\Code\WebBackend\src\Models\ModelLocationExtension.py", "Python", 136, 0, 0, 0, 0, 11, 32, 179
"c:\Users\shado\Desktop\Desktop\Documents\ComputerProgramme\Code\WebBackend\src\Models\ModelMmx.py", "Python", -49, 0, 0, 0, 0, 0, -24, -73
"c:\Users\shado\Desktop\Desktop\Documents\ComputerProgramme\Code\WebBackend\src\Models\ModelMmxData.py", "Python", 75, 0, 0, 0, 0, 11, 32, 118
"c:\Users\shado\Desktop\Desktop\Documents\ComputerProgramme\Code\WebBackend\src\Models\ModelPublic.py", "Python", -129, 0, 0, 0, 0, -27, -15, -171
"c:\Users\shado\Desktop\Desktop\Documents\ComputerProgramme\Code\WebBackend\src\Models\ModelRunningAccount.py", "Python", 34, 0, 0, 0, 0, 0, 13, 47
"c:\Users\shado\Desktop\Desktop\Documents\ComputerProgramme\Code\WebBackend\src\Models\ModelSqlAlchemySession.py", "Python", 68, 0, 0, 0, 0, 12, 27, 107
"c:\Users\shado\Desktop\Desktop\Documents\ComputerProgramme\Code\WebBackend\src\Models\ModelTableInformation.py", "Python", -9, 0, 0, 0, 0, 0, 1, -8
"c:\Users\shado\Desktop\Desktop\Documents\ComputerProgramme\Code\WebBackend\src\Models\ModelTypera.py", "Python", -1, 0, 0, 0, 0, 0, 1, 0
"c:\Users\shado\Desktop\Desktop\Documents\ComputerProgramme\Code\WebBackend\src\Models\ModelUser.py", "Python", -66, 0, 0, 0, 0, 0, -20, -86
"c:\Users\shado\Desktop\Desktop\Documents\ComputerProgramme\Code\WebBackend\src\Models\ModelUserExtension.py", "Python", 85, 0, 0, 0, 0, 11, 29, 125
"c:\Users\shado\Desktop\Desktop\Documents\ComputerProgramme\Code\WebBackend\src\Models\ModelUserGroup.py", "Python", -42, 0, 0, 0, 0, -11, -17, -70
"c:\Users\shado\Desktop\Desktop\Documents\ComputerProgramme\Code\WebBackend\src\Models\ORM.py", "Python", -50, 0, 0, 0, 0, 0, -11, -61
"c:\Users\shado\Desktop\Desktop\Documents\ComputerProgramme\Code\WebBackend\src\Models\PublicModel.py", "Python", 128, 0, 0, 0, 0, 27, 15, 170
"c:\Users\shado\Desktop\Desktop\Documents\ComputerProgramme\Code\WebBackend\src\Models\PublicValues.py", "Python", -3, 0, 0, 0, 0, -11, -1, -15
"c:\Users\shado\Desktop\Desktop\Documents\ComputerProgramme\Code\WebBackend\src\Models\PublicValuesAndSchemas.py", "Python", 93, 0, 0, 0, 0, 14, 21, 128
"c:\Users\shado\Desktop\Desktop\Documents\ComputerProgramme\Code\WebBackend\src\Models\Session.py", "Python", -76, 0, 0, 0, 0, -12, -24, -112
"c:\Users\shado\Desktop\Desktop\Documents\ComputerProgramme\Code\WebBackend\src\Models\UserGroup.py", "Python", 42, 0, 0, 0, 0, 11, 17, 70
"c:\Users\shado\Desktop\Desktop\Documents\ComputerProgramme\Code\WebBackend\src\Models\__init__.py", "Python", 207, 0, 0, 0, 0, 0, 2, 209
"c:\Users\shado\Desktop\Desktop\Documents\ComputerProgramme\Code\WebBackend\src\__init__.py", "Python", -3, 0, 0, 0, 0, -12, -1, -16
"Total", "-", 306, 0, -99, -114, -99, 31, 55, 80